WWWWWWWWWW
W KWWWWW W
W b O  W W
WXXX XXW W
W      W W
W B   W  I
W    W   W
W   W    W
W  X S   W
WWWWWWWWWW

10 5