WWWWWWWWWW
WB       W
W   b    W
W   WW   W
W  WK P  W
W R WW SOW
WWWWWWWWWW
W       sW
W TW     I
WWWWWWWWWW

10 8