WWWWWWWWWW
WW  b   WW
W WB   W W
W bW  W  W
W W WW   W
WS  WW  KW
W  W  W  W
W W    X W
WwX    CWW
WWWWWIWWWW

5 10