WWWWWWWWWW
W      K I
W        W
W   HH   W
W        W
W       sW
W        W
W   O    W
WB  OAT SW
WWWWWWWWWW

10 1