WWWWWWWWWW
WB      SW
W       sW
W        W
W     b  W
W     HH W
WD       W
WWW     WW
WKX    W I
WWWWWWWWWW

10 8