WWWWWWWWWW
WB  R   SW
W        W
W        W
WT       W
WWWWWIWXWW
WG      gW
W  WWWWWWW
WT  K   sW
WWWWIWWWWW

4 10