WWWWWWWWWW
W  b  I  W
WW WWWWW W
I W  A X W
WWWYWW X W
WW W W WWW
W   K   sW
WwWWWWWWWW
W      SBW
WWWWWWWWWW

-1 3