WWWWWWWWWW
W SA     W
W  WWWWW W
W        W
WXT b    W
WKX WW   W
WTW      W
WTBT    YI
WTTT    YW
WWWWWWWWWW

10 7