WWWWWWWWWW
W S    B W
W        W
W        W
W        W
W   t    W
W        W
W        W
W        W
WWWWWWWW W

8 10
